11111111111111111111111111
1001000Z000C110010000000C1
10000111110011000011111001
1P001100000000000110000001
1000C000000011000C00000001
11111011111111111110111111
11111Z11111111111110111111
10010000000C110010000000C1
10000111110011000011111001
1000110000000000011E000001
1000C000000011000C00000001
11111111111111111111111111